#####s###.
t..##...#.
##...##.#.
#..#....#.
#########.
